Total: 14
1969 	 ..............
3475 	 ..............
15628 	 ..............
19728 	 ..............
25835 	 ..............
28139 	 ..............
30920 	 ..............
32741 	 ..............
40398 	 ..............
46191 	 ..............
65008 	 ..............
66181 	 ..............
137674 	 ..............
140585 	 ..............
